█████████████████████
█         █         █
█ ██ ████ █ ████ ██ █
█                   █
█ ██ █ ███████ █ ██ █
█    █    █    █    █
████ ████ █ ████ ████
   █ █         █ █   
████ █ ███ ███ █ ████
       █1234 █       
████ █ ███████ █ ████
   █ █         █ █   
████ █ ███████ █ ████
█         █         █
█ ██ ████ █ ████ ██ █
█  █      0      █  █
██ █ █ ███████ █ █ ██
█    █    █    █    █
█ ███████ █ ███████ █
█                   █
█████████████████████