┏━━━━━━━━━━━━━━━━━━┓
┃1                2┃
┃ ━━━━━━━━━━━━━━━━ ┃
┃        0         ┃
┃ ━━━━━━━━━━━━━━━━ ┃
┃                  ┃
┃ ━━━━━━━━━━━━━━━━ ┃
┃4                3┃
┗━━━━━━━━━━━━━━━━━━┛