██████████████████████████████████████████
██                  ██                  ██
██  ████  ████████  ██  ████████  ████  ██
██                                      ██
██  ████  ██  ██████████████  ██  ████  ██
██        ██        ██        ██        ██
████████  ████████  ██  ████████  ████████
      ██  ██                  ██  ██      
████████  ██  ██████  ██████  ██  ████████
              ██1234      ██              
████████  ██  ██████████████  ██  ████████
      ██  ██                  ██  ██      
████████  ██  ██████████████  ██  ████████
██                  ██                  ██
██  ████  ████████  ██  ████████  ████  ██
██    ██            0             ██    ██
████  ██  ██  ██████████████  ██  ██  ████
██        ██        ██        ██        ██
██  ██████████████  ██  ██████████████  ██
██                                      ██
██████████████████████████████████████████